30 15
##############################
#............................#
#............................#
#..............P.............#
#............................#
#.............####...........#
#............................#
#........E...........##......#
#....#####################...#
#............................#
#.....................#......#
#.............E..............#
#............##....#.........#
#..E...........E.............#
#######..#########...#########



Tests enemies and player interactions.