32 23
################################
#..............................#
#..............................#
#..............................#
#.................CCC..........#
#..................E...........#
#....CCC.......########........#
#.....E........................#
#..#########.............CCC...#
#................P.............#
#...E........E..........#....E.#
##########..###......###########
##################..##########.#
#CCC......#..............CCC...#
#.........#..CCC........E......#
#####.....######....#########..#
#..............########........#
#....CCC.......................#
#..#########...................#
#FF..CCCC.................CCC..#
#FF..E.........####.......E....#
#########....E......############
#################...############

Tests whole game logic (just small level).