30 7
##############################
#............................#
#...........###..............#
#...........#P#..............#
#...........###..............#
#...E.............E..........#
#############..###############


Tests enemy strong striking logic (against each other).