30 7
##############################
#............................#
#............................#
#............................#
#............................#
#.P...............E..........#
##############################

Tests interaction between player and the enemy (bullets, killings...).