30 15
##############################
#..............P.............#
#............................#
#............................#
#............................#
#.............####...........#
#.............####...........#
#....................##......#
#....#####################...#
#............................#
#.....................#......#
#............................#
#............##....#.........#
#............................#
#######..#########...#########



Tests player movement (horizontal movement, jumps, gravity, falling off the map).