30 7
##############################
#............................#
#............................#
#.............CC.............#
#.....CC.....................#
#..............P......CC.....#
##############################


Tests coin logic (rendring, colecting and proper score adding).