30 7
##############################
#............................#
#...........###..............#
#...........#P#..............#
#...........###..............#
#.................E..........#
#..#####################.....#


Tests enemy movement logic (changing direction, striking bullets, avoiding falling off the edge).